000000000000000000000000000000000000000000000000000000000000000000000000000000000000000555
000000000000000000000000000000000000000000000000000000000000000000000000000000000000000555
000000000000000001222222222222222www222222222222222300000000000000000000000000000000000555
000000000000000015555555555555555000555555555555555530000000000000000000000000000000000555
000000000gg0000155555555555555555555555555555555555553000000000000000000000000000000000555
122222222222222555555555555555555555555555555555555555300000000000000000000000000000000555
455555555555555555555555555555555555555555555555555555530000000000000000000000000000000555
755555555555555555555555555555555555555555555555555555552222222222222222222222222230000555
755555555555555555555555555555555555555555555555555555555555555555555555555555555560000555
755555555555555555555555555555555555555555555555555555555555555555555555555555555560000555
788888888888888888888888888888888888888888888888888888888888888888888888888888888890000555
000000000000000000000000000000000000000000000000000000000000000000000000000000000000000555
000000000000000000000000000000000000000000000000000000000000000000000000000000000000000555
000000000000000000000000000000000000000000000000000000000000000000000000000000000000000555
000000000000000000000000000000000000000000000000000000000000000000000000000000000000000555
000000000000000000000000000300001222222222222230000000000000000000000000000000000000000555
000000000000000000000000000600004555555555555553000000000000000000000000000000000000000555
000000000000000000000000000600004550000000000005300000000000000000000000000000000000000555
000000000000000000000000000600004550000000000000530000000000000000000000000000000000000555
000000000000000000000000000600004555000000000000053000000000000000000000000000000000000555
000000000000000000000000000600004550000000000000055222222222222222wwwwwwwwwwwww22222222555
000000000000000000000000000600004550000000000000055555555555555555000000000000055555555555
000000000000000000000000000600004550000000000000055555555555555555555555555555555555555555
000000000000000000000000000530000000000000000000000000000000000000000000000000005555555555
000000000000000000000000000553000000000000000000000000000000000000000000000000005555555555
000000000000000000000000000555300000000000000000000000000000000000000000000000005555555555
00000000000000000000000000055553000e00000e0000000x0000000000000000000000000000005555555555
00000000000000001223000000055555222222222222222222222222222222wwewwmw222222223005555555555
000000000000000005560000000555555555555555555555555555555555550000000555555556005555555555
122222222222223000000000000555555555555555555555555555555555555555555555555556005555555555
455555555555555300000000000555555555555555555555555555555555555555555555555556005555555555
455555555555555530000000000788888888888888888888888888888888888888888888888889005555555555
455555555555555553000000000000000000000000000000000000000000000000000000000000005555555555
455555555555555555300000000000000000000000000000000000000000000000000000000000005555555555
555555555555555555522222222222222222222222222222222222222222222222222222222222225555555555
555555555555555555555555555555555555555555555555555555555555555555555555555555555555555556
555555555555555555555555555555555555555555555555555555555555555555555555555555555555555556

