000000000000000000000000e0000000000000000000000000000000000000000000000000000000000000000000000000000000000000000000000000000000000000000000000000000
00000000000000000122222223000000000000000000000000000000000000000000000000000000000000000000000000000000000000000000000000000000000000000000000000000
0000000000000000078888888900000000000000gtg0000000000000000000000000000000000000000000000000000000000000000000000000000000000000000000000000000000000
0000000000ggg0000000000000000012wwwwwwww2230000000000000000000000000000000000000000000000000000000000000000000000000000000000000000000000000000000000
00000000001230000000000000000045000000005560000000000000000000000000000000000000000000000000000000000000000000000000000000000000000000000000000000000
00000000007890000000000000000078888888888890000000000000000000000000000000000000000000000000000000000000000000000000000000000000000000000000000000000
0000000000000000000000000000000000000000000000000000000000ggg0000000000000000000000000000000000000000000000000000000000000000000000000000000000000000
x0000000000000001223000000000000000000000000000000000000005550000000000000000000000000000000000000000000000000000000000000000000000000000000000000000
00000000000000007889000000000000000000000000000000000000005550000000000000000000000000000000000000000000000000000000000000000000000000000000000000000
gggtggggg0000000000t00000000000t00000ggg0000e0000gg00000005550000000000000000000000000000000000000000000000000000000000000000000000000000000000000000
1222222222222222222222222wwww222222222222222222222230000001223000000000000000000000000000000000000000000000000000000000000000000000000000000000000000
45555555555555555555555550000555555555555555555555556000000455600000000000000000000000000000000000000000000000000000000000000000000000000000000000000
45555555555555555555555550000555555555555555555555555600000045560000000000000000000000000000000000000000000000000000000000000000000000000000000000000
45555555555555555555555555555555555555555555555555555560000004555000000000000000000000000000000000000000000000000000000000000000000000000000000000000
45555555555555555555555555555555555555555555555555555556000000455555555555555555555555555555555555555555555555555555000000000000000000000000000000000
45555555555555555555555555555555555555555555555555555555600000045555555555555555555555555555555555555555555555555555000000000000000000000000000000000
78888888888888888888888888888888888888888888888888888888890000004556555555555555555555555555555555555555555555555555000000000000000000000000000000000
00000000000000000000000000000000000000000000000000000000000000000000000000000000000000000000000000000000000000000000000000000000000000000000000000000
000000000000000000000000000000000000000000000000000000000000000000000000000000000000000q000q0e0000000000000000000000000000000000000000000000000000000
00000000000000000000000000000000000000000000000000000000001222222222222wwwwwwwwwwwwwwwwwwwwwww22222222222222222
000000000000000000000000000000000000000000000000000000000045555555555550000000000000000000000055555555555555555
000000000000000000000000000000000000000000000000000000000045555555555550000000000000000000000055555555555555555
000000000000000000000000000000000000000000000000000000000045555555555555555555555555555555555555555555555555555