000000000000000000000000000000000000000000000000000000000000000000000000000000000000000000
000000000000000000000000000000000000000q0e000000000000000000000000000000000000000000000000
0000000000000000000000000000000000000001230000000000000000000000000000000000m0e00000000000
0000000q00000000000000000000000000000007890000000000000000000000000000000001www30000000123
0000012230000000000000000s000000m000gggggg000f0000t0000000000q0l0f000000000400060000000456
x00007889000000001222222222222wwwwww222222222222222300000000122222223000000788890000000456
000000000000000015555555555555000000555555555555555530000001555555556000000000000000000456
0rsf00tggggggg0155555555555555555555555555555555555553000007888888889000000000000000000456
122222222222222555555555555555555555555555555555555555300r0000000000000000s000000000000456
45555555555555555555555555555555555555555555555555555553000ggggggggggggg0000000t0000000456
755555555555555555555555555555555555555555555555555555552222222222222222222222222230000456
755555555555555555555555555555555555555555555555555555555555555555555555555555555560000456
755555555555555555555555555555555555555555555555555555555555555555555555555555555560000456
788888888888888888555558888888888888888888888888888888888888888888888888888888888890000456
00000000000000000005556e000000000000000000000000000000000000000000000000000000000000000456
000000000000000000005560q000000000f0000000000000000000000000000000000000000000f0m000000456
000000000000000000000558300000000050000000000000000000000000000000000000000000122230000456
0000000000000000000000555300000000500000r0000000000000000000000000000000000001888890000456
00000000000000000000000555300000122222222222223000000q000000000000000000000000000000000456
000000000000000000000000555600004558888888888883000012230000000000000000000000000000000456
0000000000000000000000005556000045600e0000000007300078890000000000000000000000000000000456
000000000000000000000000555600004560000000000q00730000000000000000000000000000000000000456
00000000000000000000000055560000456005500000123004300000f00000t0000e000000q0gggggg0r0l0456
000000000000000000f0e000555600004560000000007890045222222222222222wwwwwwwwwwwww22222222556
00000000000000000012300055560000456000q005000000045555555555555555000000000000055555555556
000000000000000q018890005556p00078900ggg00000000045555555555555555555555555555555555555556
000000000000005500000000555530000000012300000000000000000000000000000000000000005555555556
00000000000q000000000000555553000000155600000000000000000000000000000000000000005555555556
000000000012300000000000555555300001888900500000000000000000000000000000000000005555555556
00000000007890000f00000055555553000000000000s00f00gggggggg00000000000000000s00005555555556
00000000000000001223000000055555222222222222222222222222222222wmwwwrw222222223005555555556
0me00gtgggggggg005560000000555555555555555555555555555555555550000000555555556005555555556
122222222222223000000000000555555555555555555555555555555555555555555555555556005555555556
455555555555555300013000000555555555555555555555555555555555555555555555555556005555555556
455555555555555530079000000788888888888888888888888888888888888888888888888889005555555556
4555555555555555530000005000000r0000000000000000000000000000000000000000000000005555555556
4555555555555555553gggggggggggggggg00m00000000s0000000f000000000q00ggggggggggggg5555555556
5555555555555555555222222222222222222222222wwwwwwwww22222222222222222222222222225555555556
555555555555555555555555555555555555555555500000000055555555555555555555555555555555555556
555555555555555555555555555555555555555555555555555555555555555555555555555555555555555556