00000000000000000000000000000000000
00000000000000000000000000000000000
00000000000000000000000000000000000
00000000000000000000000000000000000
0000x000000000000000000000000000000
00000000000000000000000000000000000
00000000000000000000000000000000000
45555555600000000000000000000000000
78888888900000000000000000000000000