00000000000000000000000000000000000
00000000000000000000000000000000000
00000000000000000000000000000000000
00000000000000000000000000000000000
000x0000000000000000000000000000000
00000000000000000000000000000000000
12222222300000000000000000000000000
45555555600000000000000000000000000
78888888900000000000000000000000000