00000000000000000000000000000000000000000000000000000000000000
00000000000000000000000000000000000000000000000000000000000000
00000000000000000000000q00000000000000000000000000000000000000
00000000000000000000001222300000000000000000000000000000000000
00000000000000000000004550000000000000000000000000000000000000
00000000000000000000007800000000000000000000000000000000000000
x000000000000000000000000000e000000000000000000000000000000000
00000000000000000000000000000000000000000000000000000000000000
gggtgggggf0l0p0s0r000000000000e0e0e00000m00000000e000000000000
12222222222222222222wwww22222222222222222222222222230000000000
45555555555555555555000055555555555555555555555555560000000000
78888888888888888888888888888888888888888888888888890000000000