00000000000000000000000000000000000000000000000000000000000000
00000000000000000000000000000000000000000000000000000000000000
000000000000000000000000e0000000000000000000000000000000000000
00000000000000000000001222300000000000000000000000000000000000
00000000000000000000004550000000000000000000000000000000000000
00000000000000000000007800000000000000000000000000000000000000
00000000000000000000000000000000000000000000000000000000000000
00000000000000000000000000000000000000000000000000000000000000
gggtggggg0000p0s0r00e000000000e00000000e0000000000000000000000
12222222222222222222222222222222222222222222222222230000000000
45555555555555555555555555555555555555555555555555560000000000
78888888888888888888888888888888888888888888888888890000000000